"","Country","Articles","Freq","SCP","MCP","MCP_Ratio"
"1","CHINA          ","1008","0.293963","830","178","0.1766"
"2","USA            "," 382","0.111403","318"," 64","0.1675"
"3","SPAIN          "," 159","0.046369","124"," 35","0.2201"
"4","UNITED KINGDOM "," 146","0.042578"," 90"," 56","0.3836"
"5","INDIA          "," 107","0.031204"," 91"," 16","0.1495"
"6","AUSTRALIA      "," 102","0.029746"," 75"," 27","0.2647"
"7","GERMANY        "," 101","0.029455"," 67"," 34","0.3366"
"8","MALAYSIA       ","  93","0.027122"," 71"," 22","0.2366"
"9","RUSSIA         ","  92","0.026830"," 83","  9","0.0978"
"10","ROMANIA        ","  78","0.022747"," 62"," 16","0.2051"
"11","BRAZIL         ","  71","0.020706"," 59"," 12","0.1690"
"12","KOREA          ","  68","0.019831"," 48"," 20","0.2941"
"13","CANADA         ","  66","0.019248"," 47"," 19","0.2879"
"14","ITALY          ","  55","0.016040"," 40"," 15","0.2727"
"15","JAPAN          ","  45","0.013123"," 32"," 13","0.2889"
"16","INDONESIA      ","  41","0.011957"," 32","  9","0.2195"
"17","PORTUGAL       ","  37","0.010790"," 34","  3","0.0811"
"18","SOUTH AFRICA   ","  36","0.010499"," 29","  7","0.1944"
"19","UKRAINE        ","  36","0.010499"," 34","  2","0.0556"
"20","TURKEY         ","  35","0.010207"," 29","  6","0.1714"
"21","SAUDI ARABIA   ","  30","0.008749"," 21","  9","0.3000"
"22","NETHERLANDS    ","  28","0.008166"," 12"," 16","0.5714"
"23","SINGAPORE      ","  27","0.007874"," 16"," 11","0.4074"
"24","IRELAND        ","  23","0.006707"," 16","  7","0.3043"
"25","ISRAEL         ","  22","0.006416"," 18","  4","0.1818"
"26","CZECH REPUBLIC ","  21","0.006124"," 17","  4","0.1905"
"27","FINLAND        ","  20","0.005833"," 12","  8","0.4000"
"28","FRANCE         ","  20","0.005833"," 11","  9","0.4500"
"29","SWEDEN         ","  19","0.005541"," 15","  4","0.2105"
"30","AUSTRIA        ","  16","0.004666","  8","  8","0.5000"
"31","BELGIUM        ","  16","0.004666"," 10","  6","0.3750"
"32","ECUADOR        ","  16","0.004666","  7","  9","0.5625"
"33","HUNGARY        ","  16","0.004666"," 15","  1","0.0625"
"34","MEXICO         ","  16","0.004666"," 15","  1","0.0625"
"35","MOROCCO        ","  16","0.004666"," 12","  4","0.2500"
"36","POLAND         ","  16","0.004666"," 13","  3","0.1875"
"37","THAILAND       ","  16","0.004666"," 12","  4","0.2500"
"38","GREECE         ","  15","0.004374"," 11","  4","0.2667"
"39","SERBIA         ","  15","0.004374","  9","  6","0.4000"
"40","NORWAY         ","  14","0.004083","  7","  7","0.5000"
"41","PHILIPPINES    ","  14","0.004083"," 11","  3","0.2143"
"42","BULGARIA       ","  13","0.003791"," 11","  2","0.1538"
"43","COLOMBIA       ","  13","0.003791"," 12","  1","0.0769"
"44","CYPRUS         ","  13","0.003791","  9","  4","0.3077"
"45","SWITZERLAND    ","  13","0.003791","  5","  8","0.6154"
"46","CHILE          ","  12","0.003500","  8","  4","0.3333"
"47","EGYPT          ","  12","0.003500","  6","  6","0.5000"
"48","NEW ZEALAND    ","  12","0.003500","  6","  6","0.5000"
"49","JORDAN         ","  10","0.002916","  6","  4","0.4000"
"50","PAKISTAN       ","  10","0.002916","  6","  4","0.4000"
"51","SLOVAKIA       ","  10","0.002916","  5","  5","0.5000"
"52","LATVIA         ","   9","0.002625","  6","  3","0.3333"
"53","DENMARK        ","   8","0.002333","  4","  4","0.5000"
"54","IRAN           ","   8","0.002333","  5","  3","0.3750"
"55","U ARAB EMIRATES","   8","0.002333","  6","  2","0.2500"
"56","CROATIA        ","   7","0.002041","  7","  0","0.0000"
"57","KAZAKHSTAN     ","   7","0.002041","  6","  1","0.1429"
"58","QATAR          ","   7","0.002041","  4","  3","0.4286"
"59","SLOVENIA       ","   7","0.002041","  4","  3","0.4286"
"60","GHANA          ","   6","0.001750","  3","  3","0.5000"
"61","ARGENTINA      ","   5","0.001458","  4","  1","0.2000"
"62","NIGERIA        ","   5","0.001458","  3","  2","0.4000"
"63","PERU           ","   5","0.001458","  3","  2","0.4000"
"64","VIETNAM        ","   5","0.001458","  5","  0","0.0000"
"65","BOSNIA         ","   4","0.001167","  0","  4","1.0000"
"66","BRUNEI         ","   4","0.001167","  1","  3","0.7500"
"67","IRAQ           ","   4","0.001167","  2","  2","0.5000"
"68","LITHUANIA      ","   4","0.001167","  4","  0","0.0000"
"69","ESTONIA        ","   3","0.000875","  2","  1","0.3333"
"70","KUWAIT         ","   3","0.000875","  2","  1","0.3333"
"71","LEBANON        ","   3","0.000875","  1","  2","0.6667"
"72","SRI LANKA      ","   3","0.000875","  2","  1","0.3333"
"73","TANZANIA       ","   3","0.000875","  1","  2","0.6667"
"74","AFGHANISTAN    ","   2","0.000583","  1","  1","0.5000"
"75","BANGLADESH     ","   2","0.000583","  2","  0","0.0000"
"76","CAMEROON       ","   2","0.000583","  0","  2","1.0000"
"77","MALTA          ","   2","0.000583","  2","  0","0.0000"
"78","MAURITIUS      ","   2","0.000583","  2","  0","0.0000"
"79","MOLDOVA        ","   2","0.000583","  0","  2","1.0000"
"80","OMAN           ","   2","0.000583","  2","  0","0.0000"
"81","PANAMA         ","   2","0.000583","  1","  1","0.5000"
"82","TUNISIA        ","   2","0.000583","  1","  1","0.5000"
"83","YEMEN          ","   2","0.000583","  1","  1","0.5000"
"84","ALGERIA        ","   1","0.000292","  1","  0","0.0000"
"85","ARMENIA        ","   1","0.000292","  1","  0","0.0000"
"86","BAHRAIN        ","   1","0.000292","  1","  0","0.0000"
"87","BELARUS        ","   1","0.000292","  1","  0","0.0000"
"88","CAMBODIA       ","   1","0.000292","  1","  0","0.0000"
"89","COSTA RICA     ","   1","0.000292","  1","  0","0.0000"
"90","FIJI           ","   1","0.000292","  1","  0","0.0000"
"91","GEORGIA        ","   1","0.000292","  1","  0","0.0000"
"92","GUATEMALA      ","   1","0.000292","  0","  1","1.0000"
"93","GUINEA         ","   1","0.000292","  0","  1","1.0000"
"94","KENYA          ","   1","0.000292","  0","  1","1.0000"
"95","KOSOVO         ","   1","0.000292","  0","  1","1.0000"
"96","MONTENEGRO     ","   1","0.000292","  1","  0","0.0000"
"97","MOZAMBIQUE     ","   1","0.000292","  1","  0","0.0000"
"98","NAMIBIA        ","   1","0.000292","  1","  0","0.0000"
"99","SENEGAL        ","   1","0.000292","  1","  0","0.0000"
"100","URUGUAY        ","   1","0.000292","  1","  0","0.0000"
